//MAP CONVERTED BY dmm2tgm.py THIS HEADER COMMENT PREVENTS RECONVERSION, DO NOT REMOVE
"a" = (
/obj/machinery/porta_turret/ship/ngr{
	name = "Rampage Turret";
	id = "military_cant_nanami_guns";
	desc = "A custom-made energy turret made of surplus NGR parts quite clearly pulled from a scrapyard and Frontiersman energy weapons. It scans the area around it with a certain fortitude, ready to set out a blaze of lasers in the blink of an eye.";
	lethal_projectile = /obj/projectile/beam/laser/eoehoma/wasp;
	stun_projectile = /obj/projectile/beam/laser/eoehoma/wasp;
	lethal_projectile_sound = 'sound/weapons/gun/laser/e-fire.ogg';
	stun_projectile_sound = 'sound/weapons/gun/laser/e-fire.ogg';
	dir = 6;
	burst_delay = 2;
	burst_size = 4
	},
/turf/open/floor/engine/hull/reinforced/interior,
/area/ship/bridge)
"b" = (
/obj/structure/salvageable/airbase/cannon{
	pixel_y = 16;
	name = "outdated autocannon";
	desc = "A rotary cannon that seems to have rusted into place over the years. Its maintenance panel is open and you can see some parts missing."
	},
/turf/closed/wall/mineral/plastitanium/nodiagonal,
/area/ship/bridge)
"h" = (
/obj/structure/window/plasma/reinforced{
	dir = 8
	},
/obj/effect/turf_decal/industrial/warning{
	dir = 4
	},
/obj/machinery/atmospherics/components/unary/shuttle/fire_heater,
/obj/structure/window/plasma/reinforced{
	dir = 1
	},
/turf/open/floor/plasteel/dark,
/area/ship/bridge)
"i" = (
/obj/structure/salvageable/airbase/cannon{
	pixel_y = -16;
	name = "outdated autocannon";
	desc = "A rotary cannon that seems to have rusted into place over the years. Its maintenance panel is open and you can see some parts missing."
	},
/turf/closed/wall/mineral/plastitanium/nodiagonal,
/area/ship/bridge)
"k" = (
/turf/closed/wall/mineral/plastitanium,
/area/ship/bridge)
"m" = (
/turf/template_noop,
/area/template_noop)
"n" = (
/obj/structure/cable{
	icon_state = "1-2";
	layer = 3.1
	},
/obj/effect/turf_decal/trimline/opaque/syndiered/filled/warning,
/obj/effect/turf_decal/trimline/opaque/syndiered/filled/warning{
	dir = 1
	},
/obj/machinery/door/airlock/maintenance/external{
	name = "Maintenance Hatch";
	id_tag = "scarlet_sky_fighter_bolts"
	},
/turf/open/floor/plasteel/tech/grid,
/area/ship/bridge)
"p" = (
/obj/structure/cable{
	icon_state = "1-2";
	layer = 3.1
	},
/obj/effect/turf_decal/trimline/opaque/syndiered/filled/warning,
/obj/effect/turf_decal/trimline/opaque/syndiered/filled/warning{
	dir = 1
	},
/obj/machinery/door/airlock/maintenance/external{
	name = "Maintenance Hatch";
	id_tag = "scarlet_sky_fighter_bolts"
	},
/obj/docking_port/mobile{
	preferred_direction = 4;
	launch_status = 0;
	name = "nanami"
	},
/turf/open/floor/plasteel/tech/grid,
/area/ship/bridge)
"s" = (
/obj/machinery/porta_turret/ship/ngr{
	name = "Rampage Turret";
	id = "military_cant_nanami_guns";
	desc = "A custom-made energy turret made of surplus NGR parts quite clearly pulled from a scrapyard and Frontiersman energy weapons. It scans the area around it with a certain fortitude, ready to set out a blaze of lasers in the blink of an eye.";
	lethal_projectile = /obj/projectile/beam/laser/eoehoma/wasp;
	stun_projectile = /obj/projectile/beam/laser/eoehoma/wasp;
	lethal_projectile_sound = 'sound/weapons/gun/laser/e-fire.ogg';
	stun_projectile_sound = 'sound/weapons/gun/laser/e-fire.ogg';
	dir = 5;
	burst_delay = 2;
	burst_size = 4
	},
/turf/open/floor/engine/hull/reinforced/interior,
/area/ship/bridge)
"t" = (
/obj/structure/grille,
/obj/structure/window/plasma/reinforced/plastitanium,
/obj/structure/cable{
	icon_state = "0-2"
	},
/obj/structure/cable{
	icon_state = "2-8"
	},
/turf/open/floor/plating,
/area/ship/bridge)
"u" = (
/obj/machinery/atmospherics/pipe/simple/orange/hidden{
	dir = 9
	},
/obj/structure/catwalk/over/plated_catwalk/dark,
/obj/structure/cable{
	icon_state = "5-8"
	},
/obj/structure/cable{
	icon_state = "1-2";
	layer = 3.1
	},
/obj/structure/closet/wall/red/directional/east,
/obj/item/storage/firstaid/ancient,
/obj/item/storage/ration/pepperoni_pizza_slice,
/obj/item/storage/ration/pepper_jack_beef_patty,
/obj/item/storage/ration/pepper_jack_beef_patty,
/obj/item/storage/ration/crayons,
/obj/item/storage/toolbox/emergency,
/obj/item/hatchet/wooden,
/obj/item/melee/knife/survival,
/obj/item/gun/ballistic/automatic/pistol/ringneck/indie,
/obj/item/ammo_box/magazine/m10mm_ringneck,
/obj/item/ammo_box/magazine/m10mm_ringneck,
/obj/item/storage/toolbox/ammo/c10mm,
/obj/effect/decal/cleanable/dirt,
/turf/open/floor/plating/rust,
/area/ship/bridge)
"v" = (
/obj/machinery/power/smes/engineering{
	input_attempt = 0;
	output_attempt = 0
	},
/obj/effect/turf_decal/techfloor{
	dir = 1
	},
/obj/structure/cable{
	icon_state = "0-9"
	},
/obj/machinery/light/small/directional/west{
	pixel_x = -28;
	pixel_y = -7
	},
/obj/machinery/button/door{
	pixel_x = -21;
	id = "scarlet_sky_fighter_bolts";
	normaldoorcontrol = 1;
	specialfunctions = 4;
	name = "Fighter Bolts";
	dir = 4;
	pixel_y = 9
	},
/obj/effect/decal/cleanable/dirt,
/obj/structure/cable{
	icon_state = "4-9"
	},
/turf/open/floor/mineral/plastitanium,
/area/ship/bridge)
"w" = (
/obj/machinery/atmospherics/components/binary/pump{
	dir = 8
	},
/obj/structure/catwalk/over/plated_catwalk/dark,
/obj/structure/cable{
	icon_state = "0-4"
	},
/obj/machinery/power/apc/auto_name/directional/south{
	start_charge = 0
	},
/obj/item/storage/toolbox/syndicate{
	pixel_x = 6;
	pixel_y = 13
	},
/obj/effect/decal/cleanable/dirt,
/turf/open/floor/plating/rust,
/area/ship/bridge)
"x" = (
/obj/machinery/atmospherics/components/binary/pump{
	dir = 8
	},
/obj/structure/catwalk/over/plated_catwalk/dark,
/obj/structure/cable{
	icon_state = "0-4"
	},
/obj/effect/decal/cleanable/dirt,
/obj/structure/chair/handrail,
/turf/open/floor/plating,
/area/ship/bridge)
"z" = (
/obj/structure/grille,
/obj/structure/window/plasma/reinforced/plastitanium,
/obj/structure/cable{
	icon_state = "0-8"
	},
/obj/structure/cable{
	icon_state = "1-8"
	},
/turf/open/floor/plating,
/area/ship/bridge)
"C" = (
/obj/structure/chair/comfy/shuttle{
	name = "grav couch";
	dir = 4;
	desc = "A comfortable seat designed to keep the seated from slipping under while partaking in intense manuevers"
	},
/obj/structure/cable{
	icon_state = "0-8"
	},
/obj/machinery/power/terminal,
/obj/effect/decal/cleanable/dirt,
/obj/machinery/turretid/ship{
	id = "military_cant_nanami_guns";
	pixel_x = -1;
	pixel_y = 29
	},
/turf/open/floor/mineral/plastitanium,
/area/ship/bridge)
"D" = (
/obj/machinery/porta_turret/ship/ngr/heavy{
	dir = 9;
	name = "Canterbury Turret";
	id = "military_cant_nanami_guns";
	desc = "A bulky turret made of broken-down equipment from the New Gorlex Republic, twin lasers humming away. Its beady camera-eye stares at you.";
	lethal_projectile_sound = 'sound/weapons/gun/laser/e40_las.ogg';
	stun_projectile_sound = 'sound/weapons/gun/laser/e40_las.ogg';
	lethal_projectile = /obj/projectile/beam/eoehoma/heavy;
	stun_projectile = /obj/projectile/beam/eoehoma/heavy;
	burst_size = 2;
	burst_delay = 5
	},
/turf/closed/wall/mineral/plastitanium/nodiagonal,
/area/ship/bridge)
"F" = (
/obj/structure/window/plasma/reinforced{
	dir = 8
	},
/obj/effect/turf_decal/industrial/warning{
	dir = 4
	},
/obj/machinery/atmospherics/components/unary/shuttle/fire_heater,
/obj/structure/window/plasma/reinforced,
/turf/open/floor/plasteel/dark,
/area/ship/bridge)
"G" = (
/obj/machinery/atmospherics/components/unary/portables_connector/visible{
	dir = 4
	},
/obj/machinery/light/small/directional/west,
/obj/machinery/portable_atmospherics/canister/fuel,
/obj/effect/decal/cleanable/dirt,
/turf/open/floor/plasteel/dark,
/area/ship/bridge)
"H" = (
/turf/open/floor/engine/hull/reinforced/interior,
/area/ship/bridge)
"I" = (
/obj/machinery/power/shuttle/engine/fire,
/turf/open/floor/engine/hull/reinforced/interior,
/area/ship/bridge)
"J" = (
/obj/structure/grille,
/obj/structure/window/plasma/reinforced/plastitanium,
/obj/structure/cable{
	icon_state = "0-8"
	},
/obj/structure/cable{
	icon_state = "4-8"
	},
/turf/open/floor/plating,
/area/ship/bridge)
"K" = (
/obj/structure/cable{
	icon_state = "6-10"
	},
/obj/structure/cable{
	icon_state = "4-8"
	},
/obj/effect/turf_decal/trimline/opaque/syndiered/filled/warning{
	dir = 4
	},
/obj/effect/turf_decal/trimline/opaque/syndiered/filled/warning{
	dir = 8
	},
/obj/machinery/door/airlock/maintenance/external{
	dir = 4;
	name = "Cockpit";
	id_tag = "scarlet_sky_fighter_bolts"
	},
/obj/effect/decal/cleanable/dirt,
/turf/open/floor/plasteel/tech/grid,
/area/ship/bridge)
"L" = (
/obj/machinery/atmospherics/pipe/manifold/orange/hidden{
	dir = 4
	},
/obj/structure/catwalk/over/plated_catwalk/dark,
/obj/structure/cable{
	icon_state = "1-4"
	},
/obj/structure/cable{
	icon_state = "2-4"
	},
/obj/effect/decal/cleanable/dirt,
/turf/open/floor/plating,
/area/ship/bridge)
"M" = (
/obj/structure/grille,
/obj/structure/window/plasma/reinforced/plastitanium,
/obj/structure/cable{
	icon_state = "0-2"
	},
/obj/structure/cable{
	icon_state = "1-2";
	layer = 3.1
	},
/turf/open/floor/plating,
/area/ship/bridge)
"N" = (
/obj/effect/turf_decal/techfloor,
/obj/structure/closet/wall/red/directional/west,
/obj/item/clothing/under/syndicate/combat{
	name = "compression suit";
	desc = "A specialized suit designed to compress the wearer, and prevent blackouts during high gravity manuevers. A patch bearing the insignia of the SCSV Raven is embroidered onto the shoulder."
	},
/obj/item/clothing/mask/gas/syndicate,
/obj/item/tank/internals/oxygen,
/obj/effect/decal/cleanable/dirt,
/obj/structure/table/reinforced,
/obj/item/clothing/suit/space/syndicate/ngr,
/obj/item/clothing/head/helmet/space/syndicate/ngr,
/turf/open/floor/mineral/plastitanium,
/area/ship/bridge)
"O" = (
/obj/effect/turf_decal/techfloor{
	dir = 8
	},
/obj/machinery/computer/helm/retro{
	dir = 8
	},
/obj/effect/decal/cleanable/dirt,
/turf/open/floor/mineral/plastitanium,
/area/ship/bridge)
"T" = (
/obj/structure/grille,
/obj/structure/window/plasma/reinforced/plastitanium,
/obj/structure/cable{
	icon_state = "0-4"
	},
/turf/open/floor/plating,
/area/ship/bridge)
"V" = (
/obj/machinery/atmospherics/pipe/simple/orange/hidden{
	dir = 10
	},
/obj/structure/catwalk/over/plated_catwalk/dark,
/obj/structure/cable{
	icon_state = "1-2";
	layer = 3.1
	},
/obj/structure/cable{
	icon_state = "2-8"
	},
/obj/effect/decal/cleanable/dirt,
/obj/structure/chair/handrail{
	dir = 8
	},
/turf/open/floor/plating/rust,
/area/ship/bridge)
"X" = (
/turf/closed/wall/mineral/plastitanium/nodiagonal,
/area/ship/bridge)
"Y" = (
/obj/machinery/porta_turret/ship/ngr/heavy{
	dir = 10;
	name = "Canterbury Turret";
	id = "military_cant_nanami_guns";
	desc = "A bulky turret made of broken-down equipment from the New Gorlex Republic, twin lasers humming away. Its beady camera-eye stares at you.";
	lethal_projectile_sound = 'sound/weapons/gun/laser/e40_las.ogg';
	stun_projectile_sound = 'sound/weapons/gun/laser/e40_las.ogg';
	lethal_projectile = /obj/projectile/beam/eoehoma/heavy;
	stun_projectile = /obj/projectile/beam/eoehoma/heavy;
	burst_size = 2;
	burst_delay = 5
	},
/turf/closed/wall/mineral/plastitanium/nodiagonal,
/area/ship/bridge)

(1,1,1) = {"
m
I
X
I
m
"}
(2,1,1) = {"
D
h
X
F
Y
"}
(3,1,1) = {"
X
x
G
w
X
"}
(4,1,1) = {"
n
V
L
u
p
"}
(5,1,1) = {"
b
X
K
X
i
"}
(6,1,1) = {"
X
N
C
v
X
"}
(7,1,1) = {"
k
T
O
J
k
"}
(8,1,1) = {"
s
t
M
z
a
"}
(9,1,1) = {"
m
H
H
H
m
"}
