//MAP CONVERTED BY dmm2tgm.py THIS HEADER COMMENT PREVENTS RECONVERSION, DO NOT REMOVE
"a" = (
/obj/machinery/porta_turret/ship/ngr{
	name = "Architect Turret";
	id = "addust_pod";
	desc = "A custom-made sentry turret built out of the remains of destroyed New Gorlex Republic and Ramzi Clique equipment. Fitted to deter intruders.";
	lethal_projectile = /obj/projectile/beam/laser/eoehoma;
	stun_projectile = /obj/projectile/beam/laser/eoehoma;
	lethal_projectile_sound = 'sound/weapons/gun/laser/e-fire.ogg';
	stun_projectile_sound = 'sound/weapons/gun/laser/e-fire.ogg';
	dir = 6
	},
/turf/closed/wall/mineral/plastitanium,
/area/ship/bridge)
"c" = (
/obj/effect/turf_decal/industrial/traffic{
	dir = 1
	},
/obj/effect/turf_decal/techfloor,
/obj/machinery/power/port_gen/pacman,
/obj/structure/cable{
	icon_state = "0-8"
	},
/obj/machinery/light/small/directional/east{
	pixel_y = 12;
	pixel_x = 28
	},
/obj/structure/cable{
	icon_state = "2-8"
	},
/obj/machinery/airalarm/directional/east{
	pixel_x = 27;
	pixel_y = -2
	},
/turf/open/floor/plasteel/patterned/brushed,
/area/ship/bridge)
"e" = (
/obj/machinery/computer/helm{
	dir = 8
	},
/obj/structure/cable/yellow{
	icon_state = "1-2"
	},
/obj/effect/turf_decal/techfloor{
	dir = 1
	},
/obj/effect/turf_decal/industrial/traffic,
/obj/machinery/turretid/lethal{
	pixel_y = 36;
	id = "addust_pod";
	pixel_x = -5
	},
/obj/effect/decal/cleanable/dirt/dust,
/obj/item/radio/intercom/wideband/directional/north{
	pixel_x = -4;
	pixel_y = 27;
	layer = 2.7
	},
/obj/item/reagent_containers/food/drinks/soda_cans/sol_dry{
	pixel_x = -6;
	pixel_y = 24
	},
/obj/item/reagent_containers/food/drinks/soda_cans/sol_dry{
	pixel_x = -7;
	pixel_y = 0
	},
/obj/item/reagent_containers/food/drinks/soda_cans/sol_dry{
	pixel_x = -3;
	pixel_y = 23
	},
/turf/open/floor/plasteel/patterned/brushed,
/area/ship/bridge)
"f" = (
/obj/effect/turf_decal/industrial/traffic{
	dir = 4
	},
/obj/effect/turf_decal/industrial/traffic{
	dir = 8
	},
/obj/machinery/door/poddoor{
	dir = 4;
	id = "pod_fore"
	},
/obj/structure/cable{
	icon_state = "0-8"
	},
/obj/machinery/power/shieldwallgen/atmos/roundstart{
	id = "addustbunker_pod_frontdoor"
	},
/obj/effect/decal/cleanable/dirt/dust,
/turf/open/floor/engine/hull/reinforced/interior,
/area/ship/bridge)
"g" = (
/obj/structure/cable/yellow{
	icon_state = "0-2"
	},
/obj/machinery/power/terminal{
	dir = 8
	},
/turf/closed/wall/mineral/plastitanium/nodiagonal,
/area/ship/bridge)
"h" = (
/obj/structure/marker_beacon{
	pixel_x = -11;
	pixel_y = 14
	},
/obj/effect/turf_decal/industrial/fire,
/obj/effect/decal/cleanable/dirt/dust,
/obj/machinery/atmospherics/components/unary/outlet_injector/on/layer4{
	dir = 4
	},
/turf/open/floor/engine/hull/reinforced/interior{
	name = "exterior reinforced hull plating"
	},
/area/ship/bridge)
"i" = (
/obj/effect/turf_decal/industrial/traffic{
	dir = 4
	},
/obj/effect/turf_decal/industrial/traffic{
	dir = 8
	},
/obj/machinery/door/poddoor{
	dir = 4;
	id = "pod_fore"
	},
/obj/structure/cable{
	icon_state = "0-8"
	},
/obj/machinery/power/shieldwallgen/atmos/roundstart{
	id = "addustbunker_pod_frontdoor";
	dir = 1
	},
/obj/effect/decal/cleanable/dirt/dust,
/turf/open/floor/engine/hull/reinforced/interior,
/area/ship/bridge)
"k" = (
/obj/structure/window/reinforced{
	dir = 8
	},
/obj/structure/window/reinforced{
	dir = 1
	},
/obj/machinery/power/smes/shuttle/precharged,
/obj/machinery/door/poddoor/shutters/preopen{
	id = "pod_window"
	},
/obj/structure/cable/yellow{
	icon_state = "0-8"
	},
/obj/machinery/atmospherics/pipe/simple/scrubbers/hidden/layer4{
	dir = 10
	},
/turf/open/floor/engine/hull/reinforced,
/area/ship/bridge)
"m" = (
/obj/machinery/porta_turret/ship/ngr/heavy{
	dir = 9;
	name = "Canterbury Turret";
	id = "addust_pod";
	desc = "A bulky, lightly-reinforced turret made of NGR scrap and surplus laser weapons. This one stares at you angrily, promising the blaze of Indecipheres if you dare step out of line.";
	lethal_projectile_sound = 'sound/weapons/gun/laser/e40_las.ogg';
	stun_projectile_sound = 'sound/weapons/gun/laser/e40_las.ogg';
	lethal_projectile = /obj/projectile/beam/laser/eoehoma/heavy;
	stun_projectile = /obj/projectile/beam/laser/eoehoma/heavy;
	burst_size = 2;
	burst_delay = 5
	},
/turf/closed/wall/mineral/plastitanium/nodiagonal,
/area/ship/bridge)
"n" = (
/obj/effect/turf_decal/industrial/traffic{
	dir = 1
	},
/obj/structure/railing{
	dir = 8
	},
/obj/structure/cable,
/obj/structure/cable/yellow{
	icon_state = "0-4"
	},
/obj/effect/turf_decal/techfloor,
/obj/item/stack/sheet/mineral/plasma/twenty,
/obj/item/stack/sheet/mineral/plasma/five,
/obj/item/stack/sheet/mineral/plasma/five,
/obj/item/wrench,
/obj/item/pickaxe/mini,
/obj/item/flashlight/flare{
	pixel_y = 3
	},
/obj/item/flashlight/flare,
/obj/item/flashlight/flare{
	pixel_y = -3
	},
/obj/item/storage/toolbox/emergency/shuttle/electric,
/obj/item/tank/internals/emergency_oxygen/double,
/obj/item/clothing/mask/gas,
/obj/item/tank/internals/emergency_oxygen/double,
/obj/item/clothing/mask/gas,
/obj/item/tank/internals/emergency_oxygen/double,
/obj/item/clothing/mask/gas,
/obj/machinery/power/smes/engineering{
	input_level = 10000;
	output_level = 9000
	},
/obj/item/oxygen_candle,
/obj/item/oxygen_candle,
/obj/item/oxygen_candle,
/obj/item/oxygen_candle,
/obj/item/oxygen_candle,
/obj/item/oxygen_candle,
/obj/structure/closet/wall/red/directional/south,
/turf/open/floor/plasteel/patterned/brushed,
/area/ship/bridge)
"p" = (
/obj/structure/chair/comfy/shuttle{
	dir = 4;
	layer = 3.3
	},
/obj/effect/turf_decal/techfloor{
	dir = 1
	},
/obj/effect/turf_decal/industrial/traffic,
/obj/machinery/button/door{
	dir = 4;
	pixel_y = -6;
	pixel_x = -22;
	name = "Aft Door";
	id = "pod_aft"
	},
/obj/machinery/button/door{
	dir = 4;
	pixel_x = -32;
	name = "Window Shutters";
	id = "pod_window"
	},
/obj/machinery/button/door{
	dir = 4;
	pixel_y = 6;
	pixel_x = -22;
	name = "Fore Door";
	id = "pod_fore"
	},
/obj/machinery/light_switch{
	dir = 4;
	pixel_x = -31;
	pixel_y = -11
	},
/obj/machinery/button/shieldwallgen{
	id = "addustbunker_pod_frontdoor";
	dir = 4;
	pixel_x = -31;
	pixel_y = 9
	},
/obj/effect/decal/cleanable/dirt/dust,
/obj/machinery/atmospherics/pipe/simple/scrubbers/hidden/layer4,
/turf/open/floor/plasteel/patterned/brushed,
/area/ship/bridge)
"q" = (
/obj/machinery/light/small/directional/west,
/obj/effect/turf_decal/techfloor,
/obj/effect/turf_decal/industrial/traffic{
	dir = 1
	},
/obj/structure/cable,
/obj/machinery/power/ship_gravity,
/turf/open/floor/plasteel/patterned/brushed,
/area/ship/bridge)
"t" = (
/turf/closed/wall/mineral/plastitanium/nodiagonal,
/area/ship/bridge)
"u" = (
/obj/effect/turf_decal/industrial/traffic{
	dir = 1
	},
/obj/structure/railing{
	dir = 4
	},
/obj/structure/cable/yellow{
	icon_state = "2-8"
	},
/obj/structure/cable/yellow{
	icon_state = "1-8"
	},
/obj/effect/turf_decal/techfloor,
/obj/machinery/power/terminal{
	dir = 8
	},
/obj/structure/cable{
	icon_state = "0-4"
	},
/obj/item/clothing/mask/gas/syndicate,
/obj/item/tank/internals/oxygen,
/obj/item/clothing/head/helmet/space/syndicate/engie,
/obj/item/clothing/suit/space/syndicate/engie,
/obj/structure/closet/emcloset/wall/directional/south{
	populate = 0
	},
/obj/machinery/portable_atmospherics/canister/oxygen,
/obj/machinery/atmospherics/components/unary/portables_connector{
	dir = 1
	},
/obj/item/advertisement/gec{
	name = "registration sheet";
	desc = "A ship registration sheet designating the 'SV Tachi' as owned by one Addust Johnson, and authorising 'A.R.M.S-R' units to operate the vessel in certain circumstances.";
	pixel_x = 3;
	pixel_y = 1
	},
/obj/item/reagent_containers/food/drinks/waterbottle/large,
/obj/item/reagent_containers/food/drinks/waterbottle/large,
/turf/open/floor/plasteel/patterned/brushed,
/area/ship/bridge)
"v" = (
/obj/machinery/power/shuttle/engine/electric{
	dir = 4
	},
/obj/structure/cable/yellow{
	icon_state = "0-4"
	},
/obj/effect/turf_decal/industrial/fire,
/obj/machinery/atmospherics/pipe/simple/scrubbers/hidden/layer4{
	dir = 8
	},
/turf/open/floor/engine/hull/reinforced/interior{
	name = "exterior reinforced hull plating"
	},
/area/ship/bridge)
"w" = (
/obj/effect/turf_decal/siding/white,
/obj/effect/turf_decal/siding/white{
	dir = 1
	},
/obj/structure/cable{
	icon_state = "2-8"
	},
/obj/structure/cable{
	icon_state = "2-4"
	},
/obj/machinery/atmospherics/components/unary/vent_scrubber/on/layer4{
	dir = 1
	},
/turf/open/floor/pod,
/area/ship/bridge)
"x" = (
/obj/machinery/power/apc/auto_name/directional/north,
/obj/structure/cable{
	icon_state = "0-2"
	},
/obj/effect/turf_decal/industrial/traffic,
/obj/effect/turf_decal/techfloor{
	dir = 1
	},
/obj/structure/cable{
	icon_state = "2-4"
	},
/obj/structure/crate_shelf,
/obj/effect/decal/cleanable/dirt/dust,
/obj/structure/closet/crate/secure/weapon,
/obj/item/storage/toolbox/ammo/c10mm{
	pixel_x = 7;
	pixel_y = 1
	},
/obj/item/ammo_box/magazine/m10mm_cottonmouth,
/obj/item/ammo_box/magazine/m10mm_cottonmouth,
/obj/item/ammo_box/magazine/cm23,
/obj/item/gun/ballistic/automatic/pistol/cm23,
/obj/item/gun/ballistic/automatic/pistol/rattlesnake/cottonmouth{
	pixel_x = 2;
	pixel_y = 0
	},
/obj/item/ammo_box/magazine/cm23,
/obj/item/ammo_box/magazine/cm23,
/turf/open/floor/plasteel/patterned/brushed,
/area/ship/bridge)
"z" = (
/obj/structure/window/reinforced,
/obj/structure/window/reinforced{
	dir = 8
	},
/obj/machinery/power/smes/shuttle/precharged,
/obj/machinery/door/poddoor/shutters/preopen{
	id = "pod_window"
	},
/obj/structure/cable/yellow{
	icon_state = "0-8"
	},
/turf/open/floor/engine/hull/reinforced,
/area/ship/bridge)
"D" = (
/obj/machinery/porta_turret/ship/ngr{
	name = "Architect Turret";
	id = "addust_pod";
	desc = "A custom-made sentry turret built out of the remains of destroyed New Gorlex Republic and Ramzi Clique equipment. Fitted to deter intruders.";
	lethal_projectile = /obj/projectile/beam/laser/eoehoma;
	stun_projectile = /obj/projectile/beam/laser/eoehoma;
	lethal_projectile_sound = 'sound/weapons/gun/laser/e-fire.ogg';
	stun_projectile_sound = 'sound/weapons/gun/laser/e-fire.ogg';
	dir = 5
	},
/turf/closed/wall/mineral/plastitanium,
/area/ship/bridge)
"E" = (
/obj/structure/cable/yellow{
	icon_state = "1-8"
	},
/obj/effect/decal/cleanable/crayon{
	icon_state = "c";
	pixel_x = -9;
	pixel_y = -8
	},
/obj/effect/decal/cleanable/crayon{
	icon_state = "h";
	pixel_x = 5;
	pixel_y = -8
	},
/obj/effect/decal/cleanable/crayon{
	icon_state = "i";
	pixel_x = 13;
	pixel_y = -7
	},
/turf/closed/wall/mineral/plastitanium/nodiagonal,
/area/ship/bridge)
"H" = (
/obj/structure/cable{
	icon_state = "1-2"
	},
/obj/machinery/door/poddoor/shutters/preopen{
	id = "pod_window"
	},
/obj/structure/cable,
/obj/structure/grille,
/obj/structure/window/plasma/reinforced/plastitanium,
/turf/open/floor/plating,
/area/ship/bridge)
"J" = (
/obj/effect/turf_decal/siding/white,
/obj/effect/turf_decal/siding/white{
	dir = 1
	},
/obj/structure/cable/yellow{
	icon_state = "1-2"
	},
/obj/structure/cable{
	icon_state = "4-8"
	},
/obj/effect/decal/cleanable/dirt/dust,
/obj/machinery/atmospherics/components/unary/vent_pump/on,
/turf/open/floor/pod,
/area/ship/bridge)
"M" = (
/obj/effect/turf_decal/siding/white,
/obj/effect/turf_decal/siding/white{
	dir = 1
	},
/obj/structure/cable{
	icon_state = "4-8"
	},
/obj/structure/cable{
	icon_state = "2-4"
	},
/obj/structure/chair/handrail,
/turf/open/floor/pod,
/area/ship/bridge)
"N" = (
/obj/effect/turf_decal/industrial/traffic{
	dir = 4
	},
/obj/effect/turf_decal/industrial/traffic{
	dir = 8
	},
/obj/structure/cable{
	icon_state = "0-4"
	},
/obj/machinery/door/poddoor/preopen{
	id = "pod_aft";
	dir = 4
	},
/obj/machinery/door/airlock/external/glass{
	dir = 4;
	req_ship_access = 0
	},
/obj/docking_port/mobile{
	dir = 4;
	name = "tachi dock";
	port_direction = 2;
	preferred_direction = 4
	},
/turf/open/floor/engine/hull/reinforced/interior,
/area/ship/bridge)
"P" = (
/obj/machinery/power/terminal{
	dir = 8
	},
/obj/structure/cable/yellow{
	icon_state = "0-4"
	},
/obj/effect/decal/cleanable/crayon{
	icon_state = "t";
	pixel_x = -2;
	pixel_y = -9
	},
/obj/effect/decal/cleanable/crayon{
	icon_state = "a";
	pixel_x = 10;
	pixel_y = -9
	},
/turf/closed/wall/mineral/plastitanium/nodiagonal,
/area/ship/bridge)
"S" = (
/obj/machinery/power/shuttle/engine/electric{
	dir = 4
	},
/obj/structure/cable/yellow{
	icon_state = "0-4"
	},
/obj/effect/turf_decal/industrial/fire{
	dir = 1
	},
/obj/structure/marker_beacon{
	pixel_x = -11;
	pixel_y = -12
	},
/turf/open/floor/engine/hull/reinforced/interior{
	name = "exterior reinforced hull plating"
	},
/area/ship/bridge)
"W" = (
/obj/effect/turf_decal/siding/white,
/obj/effect/turf_decal/siding/white{
	dir = 1
	},
/obj/structure/cable{
	icon_state = "4-8"
	},
/obj/structure/cable{
	icon_state = "1-8"
	},
/obj/effect/decal/cleanable/dirt/dust,
/obj/structure/closet/crate/rations,
/obj/effect/mapping_helpers/crate_shelve,
/obj/item/reagent_containers/food/drinks/waterbottle/large,
/obj/item/reagent_containers/food/drinks/waterbottle/large,
/obj/item/reagent_containers/food/drinks/waterbottle/large,
/obj/item/reagent_containers/food/drinks/waterbottle/large,
/obj/item/reagent_containers/food/drinks/waterbottle/large,
/obj/item/reagent_containers/food/drinks/waterbottle/large,
/obj/item/reagent_containers/food/drinks/waterbottle/large,
/obj/item/reagent_containers/food/drinks/waterbottle/large,
/obj/item/reagent_containers/food/drinks/waterbottle/large,
/turf/open/floor/pod,
/area/ship/bridge)

(1,1,1) = {"
h
m
N
t
S
"}
(2,1,1) = {"
v
t
M
q
z
"}
(3,1,1) = {"
k
p
w
n
P
"}
(4,1,1) = {"
g
e
J
u
E
"}
(5,1,1) = {"
t
x
W
c
H
"}
(6,1,1) = {"
D
f
i
t
a
"}
